
NO ./textures/north.xpm
F         255,242,158  

 SO ./textures/south.xpm
WE    ./textures/west.xpm

     C 0,0,0     

 EA ./textures/east.xpm 


1111111111111111111111111
1000000000110000000000001 
101100000111000000S000001  
1001000000000000000000101 
1111111111111111111111111  
