
NO ./textures/north.xpm
F         255,242,158  

 SO ./textures/south.xpm
WE    ./textures/west.xpm

     C 200,200,200     

 EA ./textures/east.xpm 

11111111111111
10000000000001 
10000000S00001  
10000000000001 
11111111111111
