NO ./textures/north.xpm
SO ./textures/south.xpm
WE ./textures/west.xpm
EA ./textures/east.xpm

F 255,242,158
C 200,200,200

11111111111111
10000000000001
100000000W0011
10000000000001
11111111111111
