NO ./textures/north.xpm
SO ./textures/south.xpm
WE ./textures/west.xpm
EA ./textures/east.xpm

F 250,224,212
C 255,242,158

11111111111111
10000000000001
100000000E0011
10000000000001
11111111111111
