NO ./textures/north.xpm
 SO   ./textures/south.xpm     
   WE ./textures/west.xpm
EA         ./textures/east.xpm 

F 255,242,158
C 0,0,0

11111111111
10000000101
101100N0001
10010111111
111111  111
