
NO ./textures/north.xpm
F         255,242,158  

 SO ./textures/south.xpm
WE    ./textures/west.xpm

     C 200,200,200     

 EA ./textures/east.xpm 

1111111111111111
1000000000000111
10000000000S0111  
1000000000000111 
1111111111111111
